11111111111111111
1P0000000000C00E1
101111M1111101111
10000100000000101
10110101111110101
10000000000000001
11110111111111011
100000000000000C1
10111110111110101
10C0001M0000100M1
11110110000000001
10000100000000101
10110100111101011
10C0000000C000001
11111100111111111
1C00000M000000001
11111111111111111