11111111111111111111111111111111
1P000000C111C00000000000000E1111
10000011100000000000111000000001
100000CC1111CC1111101000000000C1
1000000000000000000000000C000001
1E000011111111111111111110001111
1000C00000C000000000C000000000E1
11111111111111111111111111111111