11111111111111111111111111111111
1P000000C111C00000000000000E1111
100000111000000M0000111000000M01
100000CC1111CC1111101000000000C1
100000000000000000000000MC000001
1E000011111111111111111110001111
10M0CM0000C000000000C0000M0M00E1
11111111111111111111111111111111