1111111111
1P000C00E1
1011110011
1000000001
1011011011
1M00000M01
1011C11011
1000000001
1011M11C01
1111111111