1111111111
1P000C00E1
1011110111
1000000001
1011011111
10000000C1
1111011111
1000000001
1011111101
1111111111