1111111111
1000000001
1011110111
1000000C01
1011011111
1000000001
1111011111
1000000001
1011111101
1111111111