1111111111
1P0X0000E1
1011110111
1000000001
1011011111
1000000M01
1111011111
1000000001
1011111101
1111111111