1111111111
1P00000001
1111111011
1000000001
1011111111
1000000001
1111011111
1000000001
1011111101
1111111111